................................................................................
................................................................................
................................................................................
................................................................................
................................................................................
................................................................................
................................................................................
......................""""#########.............................................
........................................."""""".................................
..............######............................................................
................................................................................
................................................................................
""""""""""""""""""""""""""""""""""""""""""""""""""""""""""""""""""""""""""""""""