...................................................................................................................................
...................................................................................................................................
...........................................................................................................................""......
...........................................................................##""#######.................................""""##......
........................................."""""""""....................................."""##########.."#.."""""""""""""######......
.....................................##.......................###########..........................................................
...................................................##""""##........................................................................
............................""""#########..........................................................................................
...................................................................................................................................
....................######...................................................""""""""..............................................
...................................................................#######.........................................................
..........................................................""""""............................'""""""................................
"""""""""""""""""""""""""""""""""""""""""""""""""""""""""""""""""""""""""""""""""""""""""""""""""""""""""""""""""""""""""""""""""""