.............................................................................................................................
.............................................................................................................................
.....................................................................................................................""......
.....................................................................##""#######.................................""""##......
..................................."""""""""....................................."""##########.."#.."""""""""""""######......
...............................##.......................###########..........................................................
.............................................##""""##........................................................................
......................""""#########..........................................................................................
.............................................................................................................................
..............######...................................................""""""""..............................................
.............................................................................................................................
.............................................................................................................................
"""""""""""""""""""""""""""""""""""""""""""""""""""""""""""""""""""""""""""""""""""""""""""""""""""""""""""""""""""""""""""""